GRADE	Mark got older, it sounds like (5)
GRASPED	Uttered with a little respect, it becomes understood (7)
ALTERNATE	A large sea bird swallowed every second (9)
EARTHEN	The near-breaking of ground (7)
APHORISMS	Mishaps or odd sayings (9)
ASSISTANTS	As young lass is sittin' on whale, 'tis heartless to them as helps? (10)
HOST	A whole lot of ghostwriters (4)
REGULAR	Typical! Pull over in back (7)
SINAI	Desert moan: close to speaking (5)
STIPEND	It's over, over, over, kept apart by past payment (7)
ASTERISKS	Articles by the uncentred Hazards - they usually indicate omissions (9)
GENII	Second generation wise guys? (5)
PURCHASE	Charles is being held in innocent transaction (8)
ALPINE	High altitude beer is given decoration (6)
OPENLETTER	Public message: Sea animal's eating writer with a pair of Levis (4,6)
DRAWN	Tied down holding back fighting (5)
ASPIRATED	First class marks ripped off and sucked out(9)
TRIUMPHAL	Victorious one's in last resort with Harold (9)
OVEREATEN	Stuffed 05 before a 10 (9)
ORPHCUS	A legendary string player, he joins us after turning professional (7)
EARNEST	Composition of eastern grave (7)
EPICS	Great stories about spice (5)
EXHAUST	United States taken in by tax he prepared to squander (7)
SOLIDLY	Chopped dill into a kind of bean? Hardly (7)
PALTRY	Little buddy, have a go (6)
LINGO	Nothing turns on energy like jargon (5)
BECHAMEL	Live near dromedary carrying a bit of HP Sauce (8)
ERIC	Idle section of America (4)
CANOE	Kind of eagle that is a resident of Sesame St. (5)
RETOUCHED	Accentuated the negative cry of pain during stop over? (9)
SPORTSCAR	Show off Mark's Mazda Miata, for one (6,3)
TALLY	Count Tadeusz's first friend (5)
