BARS	Stars and __ (Confederate flag)
BEAR	Animal on California's flag
ALTI	Height: Prefix
RAID	Black Flag competitor
SLEEP	Sack out
PAVE	Work with flagstones, say
PGA	Org. for players whose sport uses flags
ARR	Flight board abbr.
VAIL	Colorado ski area
ENSIGN	Ship's flag
RAG	Sleazy newspaper
REBA	Country singer McEntire
ARBS	Some Wall Streeters, for short
GUST	It may make a flag flap
ELAL	Airline to Israel
GRAND	"You're a __ Old Flag"
DEER	XING sign animal
PERU	Nation with a vicuña on its flag
PENNANT	Ballpark flag
ATIE	End in __ (draw)
ARISE	Spring up
EBBS	Flags
RIDES	Six Flags attractions
SARA	__ Lee cakes
LIE	Break an oath, perhaps
NAST	Tweed caricaturist Thomas
PACE	Walk back and forth
CEDAR	Tree on Lebanon's flag
ERIC	Guitarist Clapton
GRIN	Cheshire cat feature
IMA	"__ Little Teapot"
CCS	Duplicates: Abbr.
CAUSE	A flag-waver may have one
CDLIX	459, in old Rome
SANTA	__ Maria (Columbus's flagship)
RERUN	Any "Seinfeld," now
UNCLE	Verbal white flag
MAINE	State with a pine tree on its flag
INANE	Nonsensical
NEPAL	Nation with a five-sided flag
ERATO	Muse of poetry
ADA	Critic __ Louise Huxtable
ADIN	Tennis score after deuce
BANNER	Nation's flag
BAATH	Saddam's party
ULNA	Forearm bone
ATLANTA	Six Flags Over Georgia site
ACCRA	Ghana's capital
RELS	Fam. members
TAPA	Bite-size Spanish appetizer
SITTER	Flagpole __ (exhibitionist of sorts)
ETS	UFO pilots
LEAF	Maple __ (Canada flag emblem)
FAIR	Setting for flags from around the world
NAT	__ "King" Cole
EXALT	Praise highly
DELTA	Triangular letter
DANGER	What a red flag may signify
ELO	"Evil Woman" band
ASTA	"The Thin Man" dog
TROP	De __ (excessive)
SHIH	__ Tzu (toy dog breed)
HOIST	Raise, as a flag
ELAN	Pizazz
EDNA	Best or Ferber
LOIS	One of the Flagstons, in the funnies
ANTS	Black Flag victims
RNA	Genetic initials
ALTO	Kind of sax
ROGER	Jolly __ (pirate flag)
GLEE	Merriment
EKES	__ out (just manages)
RAPT	Wholly absorbed
DONT	"__ tread on me" (Revolutionary War flag motto)
OGLED	Gawked at
EES	Some M.I.T. grads
DRS	Rx writers
ILKA	Actress Chase
NITA	Naldi of the silents
PETER	Blue __ (ship's flag indicating imminent departure)
SEEP	Leak slowly
ASS	Pompous sort
ROSS	Flagmaker Betsy
TEST	Run up the flagpole
