ZTSQZMMH	Lock up for a long time
ZEIXC	Super bargain
TLVYUOHAPKHVL	Boaster's comment, in a cartoon?
SHP	Underground grp.
QORWZW	Commuter headaches
ZODK	Hero aviators
MZKG	Becomes pallid
MRX	Rep.
HMG	Quick assent
DJXLY	Bordering area
DOPIDH	HBO sports series
JYOG	Arduous chore
XTLG	Union symbol
LWP	Carbohydrate suffix
YICIXP	Popular drink mix
ICMQ	Tests for some coll. seniors
IQIYTAWHO	Sword lilies
CALX	Money in Port Elizabeth
MAXNVKG	They're shut at night
QEVKTLF	Guarantee
YELHOOZRM	Modern times
YEUB	Common rhyme scheme
OYTWI	Rear
QAAEB	Easy two-pointer
BWLQVA	Kitchen gadgets
EIVPRDKXGUPOLPC	Where to color cartoons?
UXHAX	N.L. team since 1969
ILXVW	End of ___
UXY	Drivers' org.
WKG	Abbr. before some state names
XIGG	Place to walk, for short
ICYXNKL	Tot
CKT	Assn.
BCUZZ	No string bean
ZKYI	Hard-hearted
LOHD	Nile slitherers
LPOJUR	Miss ___ Evans of McCullers's "Ballad of the Sad Cafe"
OKO	Sneak
CXKT	Gas: Prefix
CJOATG	Bureau
VTQ	"May ___ frank?"
OKW	Musical notes
XPKAHYYJPTAJKLV	Demand more cartoon ideas?
XDXI	Construction beam
YXZY	English literary pseudonym
YUUK	Food thickener
JUW	Capek play
ZHY	Wall St. hiree
ZHZGONI	Wanting as much change as possible?
LDOOX	Follows
LUVBFDZF	Campers' milieu
XUO	T size: Abbr.
WUGFA	Desires, with "after"
SHAILUXJ	Every other quarter
SLWRSZ	North African native
LLBW	Instant: Abbr.
DZUAAYHW	Nightspot
DPILHQW	Aristocracy
ASV	"Well, look here!"
YHRDMDTH	Grant, as a title
LZP	Immigrant's sch. course
LVIUMPPYKTSHO	Means of finding cartoon signatures?
MFQ	Monopolist
PPJ	Hindu title
ZZS	Fed. loan group
ZWHKZTFYKMWWF	Cartoons displayed on easels?
ZPWUELS	Many Christmas trees
SLYRIC	Weigh
WGKKBB	Rested (on)
KZN	Pasta name suffix
RFPI	Large number suffix
GVR	Slangy greetings
ZWPL	On/off points: Abbr.
ZLE	Jeanne, e.g.: Abbr.
ROHZWF	One with lots of bucks?
QJLEB	Sign on an elementary school door
EUW	Traveler's alternative to J.F.K.
BEM	___ Sec.
DZLHWY	Wrecks
ZCHZ	Some roulette bets
SNVN	"The Time Machine" race
DFG	Stale
FFL	___ Palmas
GYPRCS	Yoakam who sang "Honky Tonk Man"
HUEV	Wowed
VXTNKN	Goes blindly
MCEKUR	City WSW of Copenhagen
ZIL	Rembrandt van ___
IZFYUGQWMXVDH	Making lots of circles in a cartoon?
IDEJMSVFW	Set off
UJKA	"___ la Douce"
GCKG	Around
VXCO	Phone abbr.
ZEI	Russian assents
EDFLPJCW	"You better believe it!"
EEF	Good laugh
TXTZKTLC	Pogo and others
KVGO	Standout performance
YOHEE	Up's partner
YGZHTK	Writer Walker and others
OGCHLSH	Screwy
HIDQCNE	Anthem with two sets of lyrics
RKK	"Today" rival, for short
NDNCH	Title town in a John Denver song
NCLXI	Hurt
DVK	Farm enclosure
VFS	Special ___
GGIFJGYCAGICVKO	Aspiring cartoonist's problem?
GYX	Marsh
YFCXLX	1980's Defense secretary Weinberger
IJEMOK	Classic Harlem theater
JGY	What good R.N.'s dispense
JGDPVL	Sibelius's "Valse ___"
ZCD	Like Haydn's "The Fire" Symphony
MYFS	"Cool"
JLKN	A sci.
GOKAE	Chicken's place
ABFIU	Havana, informally
EHZB	Knockouts, so to speak
HHQSSXC	Kicks up one's heels?
SUWD	Third-century year
EAEX	Pedal pusher
ETZD	Cross condition
AJBT	When repeated, a cry of approval
DKD	Here, to a 108-Across
DJNG	Summer treats
KWQX	Pointed end
MBH	Lady abroad: Abbr.
TLCUV	Pass
XJTJMITQJWPNWFZ	Cartoon dialogue?
JAM	Feller
TVJ	"___ a date!"
QKG	Moo ___ pork
NFG	Wrong
KSNWF	___ Hawkins Day
LAZBO	Like some rotations
VKNQVFWIB	Nowheresville
HEDW	Word after he and she
XMDTK	In again, after being out
JGGXLGFU	It "kills" some people
