ABSCAM	U.S. political scandal involving a fictional sheik
ATSTUD	Offered for breeding
BATHMAT	Shower room sight
SCREAMS	Fun house sounds
COIL	Stamp purchase
AMNIO	Prenatal exam, briefly
MAGNI	Great: Prefix
EPEE	Sport whose name has two accents
ERN	Directional ending
POI	Polynesian paste
EXFBI	Like some private dets.
EYEON	"I've got my ___ you!"
PCS	Some tablets
POETICA	Horace's "Ars ___"
CORONAS	Mexican beer choices
SPANGLE	Glittery glue-on
TACOMA	Puget Sound city
ROXY	Classic theater name
OOP	Alley ___
STRINGKNIFE	Twine cutter?
KELP	Seaweed variety
ERA	Time for the history books
THELINE	Words after cross, down or over
BOSTON	Setting of an April marathon
STICKUP	Bank teller's fear
UMA	Thurman of "Pulp Fiction"
OILSTINTING	OPEC production cutback?
SETTYPE	Make up galleys for printing
TIER	Layer
DAMS	Reservoir producers
SASSIER	Less respectful
PEI	Louvre Pyramid architect
ICAL	Suffix with myth
TSARS	Bygone monarchs
RTE	Map no.
SPF	Hawaiian Tropic no.
TESTCASE	Legal precedent setter
SIS	What your mom might call your aunt
TCM	RKO film airer, maybe
STPATRICK	March figure ... or, when split into three parts, a title for this puzzle
ALUM	Grad
HOUSEFLY	Buzzer in the kitchen, maybe
HATCHED	Came out of one's shell
ONALEAD	Being walked, as Fido
UNKEMPT	Disheveled
SMUTS	Onetime South African P.M. Jan
TRIVIAL	Of no matter
SILENTE	End of life as we know it?
ANNI	Years in old Rome
UPI	Reuters competitor
ISLS	Archipelago's makeup: Abbr.
PRIM	Strait-laced
MERGES	Becomes one
TAKEHOMESTY	Pen for a pet pig?
HISTO	Tissue: Prefix
OCTET	Quarterfinals qualifiers, e.g.
TIKES	Little ones: Var.
YEAST	Brewing need
ILE	Suffix with project
CLERIC	Imam, e.g.
LIEOVER	Be postponed
OTTO	One of four Holy Roman emperors
HEM	Folded-over skirt part
STIRSKATING	Ice hockey in prison?
INT	Bankbook fig.
RTS	Football linemen: Abbr.
EAP	"The Raven" writer's inits.
TENT	Rental for an outdoor reception
ESTATE	Will's focus
DDT	Banned bug spray
OTTS	Some valuable 1920s-'40s baseball cards
STOLES	Fur wraps
