SUVS	Explorers on a hwy., e.g.
SWAT	Sultan of ___ (Babe Ruth)
UHUH	"No way, no how"
VICE	Gambling or drinking
SPORE	Fungus production
MISO	___ soup (starter at a Japanese restaurant)
MER	Sea, to Cousteau
IDA	Civil rights advocate ___ B. Wells
SUN	Light from above
OPTIC	Eye-related
FIVEO	Cops, in slang ... or a hint to this puzzle's theme
FARFLUNG	Widespread
IRA	Nest egg for old age, in brief
VYING	Competing
EATIN	Have dinner at home
ONTHE	Words before rocks, ropes or run
WHIPPEDUP	Made quickly, as a meal
PUMAS	Alternative to Nikes
ARYAN	Indo-European
AUCOURANT	Up-to-date
RAITT	Singer Bonnie
THERM	Gas bill unit
INF	Gershwin's "Concerto ___"
NOG	Eggy drink
NIH	Medical research agcy.
EAUDECOLOGNE	Brut or Paco Rabanne
ULEE	Beekeeper of filmdom
DALIS	Some Surrealist paintings
EMINENT	Distinguished
OVALS	Egg shapes
AHS	Physical reactions?
ALOT	Gazillions
HIHO	Bygone cracker brand
SETS	Squash match units
SLAM	Pro wrestling move
GUV	Informal British term of address
LIEV	Schreiber of "X-Men Origins: Wolverine"
VOCAB	Lexicon contents, for short
ELIS	New Haven collegians
SEEYA	"Adios!"
NADIA	Gold-medal gymnast Comaneci
DATA	Facts and figures
INON	Privy to
ADAY	The Beatles' "___ in the Life"
OHTOBEINENGLAND	Browning opening line preceding "Now that April's there"
BABAWAWA	Gilda Radner character
NMEX	Ariz. neighbor
TOSCA	1900 Puccini premiere
SEEM	Look
STOA	Site of Zeno's teaching
ABE	Civil War prez
ECO	Prefix with friendly
NYET	Natasha's refusal
TEENY	Wee
ANY	Whichever
OWEBACKTAXES	Be indebted to the I.R.S.
ONAIR	Broadcasting now
WELSH	Like the name "Bryn Mawr"
ECONO	___ Lodge
KNOBS	Door handles
STELE	Inscribed pillar
NEC	Jap. computer giant
WON	Took home the gold
ETHOS	Spirit of a group
HEIR	Prince, e.g.
ORSO	Roughly
SSTS	Former fast jets
ALOHA	"Welcome to Maui!"
HED	"I knew a man Bojangles and ___ dance for you ..."
OPIONEERS	Willa Cather novel
PUP	Young dog
IDE	Chemical suffix
ODD	Like 1, 3, 5, 7 ...
ISNEW	"So what else ___?"
BUDDYLIST	Computer setup to facilitate instant messaging
RHODA	Mary's upstairs neighbor, in 1970s TV
SPED	Floored it
EROS	Lover boy?
